0000000111111111111111111111111111111111
0000000100000000000000000000000000000001
0000000100000000000000000000000000000061
0000000100000000000000000000000000000001
0000000100000000000000000000000000010001
0002000100011111111111111111110000010061
0000000100010000100000000000000000010001
0000000100000000100000000000000000010001
0000000100000000100700000000000030010061
0000000100000000100000000000000000010061
0000000199990000100000111111110000010001
0000000100090000100000000000010000010061
0000000100090000100000000000010000010001
0000000100090000100000000000010000010001
0000000100090000100000000070010000000061
0000000100090000100000000000010000000001
0000000000000000100000000000010000000061
0000000000000000111111111100010000000001
0004000000000000000011111100080000000001
0000000000000000000011111100080000000061
0000000000000000000011111100080000000001
0000000100000070000011111100080000000061
0000000100000000000000000100080000000061
0000000100000000000000000100011111110001
0000000100000000000000000100000000710061
0000000110000990099000000100000000010001
0000000110000840408000000100000000010061
0000000110000800048000000100000000010061
0000000110000904009000000111111030010001
0000000110000900009000000999999000010001
0002000110000904409000000000009000010061
0000000110000940009000000000309000010001
0000000110000944009000000000379000010001
0000000110000900049000000000009000010061
0000000110000999999000000999999000010001
0000000100000000000000000000000000010001
0000000100000000000000000000000000010061
0000000100000000000000000000000000010001
0000000100000000000000000000000000010001
0000000111111111111111111111111111111111
