1111111111111111111111111111111100000000
1606000000000001010100000000000100000000
1000000000000001010100000000000100000000
1111101010111101010100000000000100000000
1000101010107101010100300003000100000000
1010101111100111010100000000000100000000
1017100000000000010100000000000100000000
1011101111111010010100000000000100000000
1000000000001010010100000000000100000000
1011100000001010010111001100111100000000
1010101111111010010000000000000100000000
1010101000000010010000000000000100000000
1000001011010010010111001100111100000000
1004001111010110010100000000000100000000
1000000000010100010100000000000100000000
1000000000010100010100000000000100000000
1001111011110100000100000000000100000000
1001301010170100000100000000000100000000
1001001010100100010100000000000100000000
1001001110110100010100100000000100000000
1000000000000100010100100000000100000000
1000000000000100010100100000000100000000
1111111111111111111100111111111100000000
0000000000000000000000000000000000000000
0000000000000000000000000000000000000000
0000000000000000000000000000000000000000
0000000000000000000000000000000000000000
0000000000000000000000000000000000000000
0000000000000000000000000000000000000000
0000000000000000000000000000000000000000
0000000000000000000000000000000000000000
0000000000000000000000000000000000000000
0000000000000000000000000000000000000000
0000000000000000000000000000000000000000
0000000000000000000000000000000000000000
0000000000000000000000000000000000000000
0000000000000000000000000000000000000000
0000000000000000000000000000000000000000
0000000000000000000000000000000000000000
0000000000000000000000000000000000000000
