1111111111111111111111111111000000000000
1000000000000000000000000001000000000000
1000000000000000000000000001000000000000
1000000000000000000000000001000000000000
1001001000000000000002000001000000000000
1001001000000000000000000001000000000000
1001001011111111000000000001000000000000
1001001011111701000000000001000000000000
1001001010000001100000000001000000000000
1001001016000000100000000001000000000000
1001001010000000100000000001000000000000
1111001111111100100000000001000000000000
1000000011301100100000000001000000000000
1001111111000000111111110001000000000000
1000000011000000000700010001000000000000
1111110011000000000000010001000000000000
1000000011111001111110010001000000000000
1001111110000001000010010001000000000000
1000000010000001711010010001000000000000
1111011110007001011010010001000000000000
1000000010000001011010010001000000000000
1001110110000001000007010001000000000000
1001700100000001000000010001000000000000
1001001100001111000000010001000000000000
1001001100101000000000010201000000000000
1001001000101000000000010001000000000000
1001001030101007000000010001000000000000
1001001000101000000000010001000000000000
1001001001101000000000010001000000000000
1001001001101111100000010001000000000000
1000000000000000000000010001000000000000
1111111111111111111111110001000000000000
0000000000000000000000000000000000000000
0000000000000000000000000000000000000000
0000000000000000000000000000000000000000
0000000000000000000000000000000000000000
0000000000000000000000000000000000000000
0000000000000000000000000000000000000000
0000000000000000000000000000000000000000
0000000000000000000000000000000000000000
