0000000111111111111111111111111111111111
0000000100000000000000000000000000000001
0000000100000000000000000000000000000061
0000000100000000000000000000000000000001
0000000100000000000000000000000000010001
0002000100011111111111111111110000010061
0000000100010000100000000000000000010001
0000000100000000100000000000000000010001
0000000100000000100700000000000030010061
0000000100000000100000000000000000010061
0000000111110000100000111111110000010001
0000000100010000100000000000010000010061
0000000100010000100000000000010000010001
0000000100010000100000000000010000010001
0000000100010000100000000070010000000061
0000000100010000100000000000010000000001
0000000000000000100000000000010000000061
0000000000000000111111111100010000000001
0004000000000000000011111100010000000001
0000000000000000000011111100010000000061
0000000000000000000011111100010000000001
0000000100000000000011111100010000000061
0000000100000000000000000100010000000061
0000000100000000000000000100011111110001
0000000100000000000000000100000000710061
0000000110000110011000000100000000010001
0000000110000140401000000100000000010061
0000000110000100041000000100000000010061
0000000110000104001000000111111030010001
0000000110000100001000000111111000010001
0002000110000104401000000000001000010061
0000000110000140001000000000301000010001
0000000110000144001000000000371000010001
0000000110000100041000000000001000010061
0000000110000111111000000111111000010001
0000000100000000000000000000000000010001
0000000100000000000000000000000000010061
0000000100000000000000000000000000010001
0000000100000000000000000000000000010001
0000000111111111111111111111111111111111
